//MAP CONVERTED BY dmm2tgm.py THIS HEADER COMMENT PREVENTS RECONVERSION, DO NOT REMOVE
"a" = (
/turf/open/lava/plasma/ice_moon,
/area/deathmatch)
"c" = (
/obj/machinery/door/airlock/wood,
/obj/structure/barricade/wooden/snowed,
/obj/effect/mapping_helpers/airlock/abandoned,
/turf/open/misc/asteroid/snow/icemoon/do_not_chasm,
/area/deathmatch)
"d" = (
/obj/item/stack/ore/iron,
/turf/open/misc/asteroid/snow/icemoon/do_not_chasm,
/area/deathmatch)
"e" = (
/obj/structure/flora/rock/pile/icy/style_random,
/turf/open/misc/asteroid/snow/icemoon/do_not_chasm,
/area/deathmatch)
"f" = (
/obj/item/gun/energy/plasmacutter,
/turf/open/misc/asteroid/snow/icemoon/do_not_chasm,
/area/deathmatch)
"g" = (
/obj/effect/turf_decal/weather/snow/corner{
	dir = 5
	},
/obj/effect/turf_decal/weather/snow,
/turf/open/indestructible/plating,
/area/deathmatch)
"h" = (
/turf/closed/indestructible/wood,
/area/deathmatch)
"i" = (
/turf/open/misc/asteroid/snow/icemoon/do_not_chasm,
/area/deathmatch)
"k" = (
/obj/effect/spawner/structure/window/ice,
/turf/open/indestructible/plating,
/area/deathmatch)
"l" = (
/obj/effect/spawner/random/mining_loot/pka_mod{
	pixel_x = 0;
	pixel_y = 7
	},
/obj/structure/flora/grass/brown/style_2,
/turf/open/misc/asteroid/snow/icemoon/do_not_chasm,
/area/deathmatch)
"m" = (
/turf/open/misc/asteroid/snow/ice/icemoon,
/area/deathmatch)
"n" = (
/turf/open/misc/ice/icemoon,
/area/deathmatch)
"o" = (
/obj/item/stack/ore/silver,
/turf/open/misc/asteroid/snow/icemoon/do_not_chasm,
/area/deathmatch)
"p" = (
/obj/structure/closet/crate/necropolis/tendril/demonic,
/obj/effect/spawner/random/mining_loot/pka_mod,
/obj/effect/spawner/random/mining_loot/pka_mod,
/obj/effect/spawner/random/mining_loot/pka_mod,
/turf/open/indestructible/rockyground,
/area/deathmatch)
"q" = (
/obj/structure/flora/grass/both/style_random,
/turf/open/misc/asteroid/snow/icemoon/do_not_chasm,
/area/deathmatch)
"t" = (
/obj/effect/turf_decal/weather/snow/corner{
	dir = 1
	},
/obj/effect/turf_decal/weather/snow,
/obj/item/storage/medkit/ancient,
/turf/open/indestructible/plating,
/area/deathmatch)
"w" = (
/obj/structure/flora/tree/dead/style_random,
/turf/open/misc/asteroid/snow/icemoon/do_not_chasm,
/area/deathmatch)
"x" = (
/turf/closed/indestructible/wood{
	icon_state = "icedmetal_wall-0";
	icon = 'icons/turf/walls/icedmetal_wall.dmi';
	base_icon_state = "icedmetal_wall"
	},
/area/deathmatch)
"y" = (
/turf/closed/mineral/snowmountain/icemoon,
/area/deathmatch)
"z" = (
/obj/effect/landmark/deathmatch_player_spawn,
/turf/open/misc/asteroid/snow/icemoon/do_not_chasm,
/area/deathmatch)
"A" = (
/obj/item/skeleton_key,
/turf/open/misc/asteroid/snow/icemoon/do_not_chasm,
/area/deathmatch)
"B" = (
/obj/effect/turf_decal/weather/snow/corner{
	dir = 6
	},
/obj/effect/turf_decal/weather/snow,
/turf/open/indestructible/plating,
/area/deathmatch)
"E" = (
/obj/structure/flora/rock/icy/style_random,
/turf/open/misc/asteroid/snow/icemoon/do_not_chasm,
/area/deathmatch)
"F" = (
/turf/closed/indestructible/rock/snow/ice/ore,
/area/deathmatch)
"G" = (
/obj/item/stack/ore/gold,
/turf/open/misc/asteroid/snow/icemoon/do_not_chasm,
/area/deathmatch)
"H" = (
/obj/structure/flora/grass/green/style_random,
/turf/open/misc/asteroid/snow/icemoon/do_not_chasm,
/area/deathmatch)
"I" = (
/obj/effect/turf_decal/weather/snow/corner{
	dir = 10
	},
/obj/effect/turf_decal/weather/snow,
/turf/open/indestructible/plating,
/area/deathmatch)
"J" = (
/obj/structure/flora/rock/icy,
/turf/open/misc/asteroid/snow/icemoon/do_not_chasm,
/area/deathmatch)
"K" = (
/obj/item/stack/rods/lava{
	amount = 2
	},
/turf/open/misc/asteroid/snow/icemoon/do_not_chasm,
/area/deathmatch)
"L" = (
/obj/item/stack/ore/uranium,
/turf/open/misc/asteroid/snow/icemoon/do_not_chasm,
/area/deathmatch)
"M" = (
/obj/item/stack/ore/bluespace_crystal,
/obj/item/stack/ore/iron,
/turf/open/misc/asteroid/snow/icemoon/do_not_chasm,
/area/deathmatch)
"N" = (
/obj/structure/flora/grass/brown/style_random,
/turf/open/misc/asteroid/snow/icemoon/do_not_chasm,
/area/deathmatch)
"O" = (
/obj/effect/spawner/structure/window/ice,
/obj/structure/barricade/wooden/crude/snow,
/turf/open/indestructible/plating,
/area/deathmatch)
"Q" = (
/obj/structure/flora/tree/pine/style_2,
/turf/open/misc/asteroid/snow/icemoon/do_not_chasm,
/area/deathmatch)
"S" = (
/obj/effect/turf_decal/weather/snow/corner{
	dir = 9
	},
/obj/effect/turf_decal/weather/snow,
/turf/open/indestructible/plating,
/area/deathmatch)
"T" = (
/turf/open/cliff/snowrock,
/area/deathmatch)
"U" = (
/turf/closed/mineral/gibtonite/ice/icemoon,
/area/deathmatch)
"V" = (
/obj/structure/flora/tree/dead/style_6,
/turf/open/misc/asteroid/snow/icemoon/do_not_chasm,
/area/deathmatch)
"Y" = (
/obj/structure/flora/tree/dead/style_2,
/turf/open/misc/asteroid/snow/icemoon/do_not_chasm,
/area/deathmatch)
"Z" = (
/obj/effect/turf_decal/weather/snow/corner,
/obj/effect/turf_decal/weather/snow,
/turf/open/indestructible/plating,
/area/deathmatch)

(1,1,1) = {"
F
F
F
F
F
F
F
F
F
F
F
F
F
F
F
F
F
F
F
F
F
F
F
F
F
"}
(2,1,1) = {"
F
y
y
y
y
y
y
y
y
y
y
y
y
y
y
y
y
y
y
y
y
y
y
y
F
"}
(3,1,1) = {"
F
y
y
i
i
y
y
U
y
y
y
y
y
y
y
y
y
y
i
y
y
y
y
y
F
"}
(4,1,1) = {"
F
y
i
w
l
i
y
y
y
y
y
y
y
y
y
G
i
i
i
L
y
y
U
y
F
"}
(5,1,1) = {"
F
y
y
i
i
y
y
y
y
y
y
y
y
i
i
i
i
E
i
m
y
y
y
y
F
"}
(6,1,1) = {"
F
y
y
y
i
y
y
y
y
y
y
y
y
i
z
i
i
i
i
m
m
m
y
y
F
"}
(7,1,1) = {"
F
y
y
y
y
y
y
y
y
y
y
y
i
i
E
i
i
e
i
i
m
m
m
y
F
"}
(8,1,1) = {"
F
y
y
y
y
y
y
y
y
y
y
y
i
i
i
i
i
i
i
J
i
i
i
y
F
"}
(9,1,1) = {"
F
y
y
y
y
y
y
y
y
y
y
i
i
e
i
i
a
a
i
i
i
i
z
y
F
"}
(10,1,1) = {"
F
y
y
y
y
y
y
y
U
y
M
i
i
i
A
a
a
a
a
i
i
E
i
y
F
"}
(11,1,1) = {"
F
y
y
y
y
y
y
y
y
y
i
E
i
i
a
a
a
a
a
i
i
i
i
y
F
"}
(12,1,1) = {"
F
y
y
y
y
y
y
y
y
y
i
i
i
a
a
p
T
a
a
i
e
i
d
U
F
"}
(13,1,1) = {"
F
y
y
y
y
y
y
y
y
y
i
i
i
a
a
a
a
a
a
i
i
i
i
y
F
"}
(14,1,1) = {"
F
y
y
y
m
m
i
y
y
y
i
z
i
i
a
a
a
a
i
i
i
i
i
y
F
"}
(15,1,1) = {"
F
y
i
i
m
i
i
z
y
y
y
i
E
i
i
i
a
a
i
i
E
i
i
y
F
"}
(16,1,1) = {"
F
i
q
i
i
i
Y
i
i
y
y
y
i
i
i
i
e
i
i
i
i
z
i
y
F
"}
(17,1,1) = {"
F
y
z
Q
i
i
i
N
i
i
y
y
i
i
e
i
i
i
i
e
i
i
i
y
F
"}
(18,1,1) = {"
F
y
i
i
K
H
i
i
i
i
n
y
y
y
i
i
i
E
i
i
i
n
n
y
F
"}
(19,1,1) = {"
F
y
h
O
k
x
i
i
i
n
n
y
y
y
o
i
z
i
i
i
n
n
n
n
F
"}
(20,1,1) = {"
F
y
h
S
I
x
H
i
i
n
n
n
y
y
y
y
y
y
m
n
n
n
n
n
F
"}
(21,1,1) = {"
F
y
x
t
Z
c
i
i
i
H
n
n
n
n
y
y
y
y
y
n
n
f
n
n
F
"}
(22,1,1) = {"
F
y
h
g
B
h
q
i
V
i
n
n
n
n
n
n
n
y
n
n
n
n
n
y
F
"}
(23,1,1) = {"
F
y
x
x
h
x
i
z
i
y
y
y
n
n
n
n
n
n
n
n
n
n
y
y
F
"}
(24,1,1) = {"
F
y
y
y
y
y
y
y
y
y
y
y
y
d
i
n
n
n
n
n
y
y
y
y
F
"}
(25,1,1) = {"
F
F
F
F
F
F
F
F
F
F
F
F
F
F
F
F
F
F
F
F
F
F
F
F
F
"}
