//MAP CONVERTED BY dmm2tgm.py THIS HEADER COMMENT PREVENTS RECONVERSION, DO NOT REMOVE
"a" = (
/turf/open/water/deep_beach/lethal,
/area/deathmatch/fullbright)
"d" = (
/turf/open/misc/beach/coast{
	dir = 10
	},
/area/deathmatch/fullbright)
"e" = (
/obj/structure/hedge,
/turf/open/indestructible/hotelwood,
/area/deathmatch/fullbright)
"f" = (
/obj/structure/chair/pew/left{
	dir = 1
	},
/turf/open/indestructible/hotelwood,
/area/deathmatch/fullbright)
"g" = (
/turf/open/misc/beach/coast/corner,
/area/deathmatch/fullbright)
"h" = (
/obj/structure/chair/pew/right{
	dir = 1
	},
/turf/open/indestructible/hotelwood,
/area/deathmatch/fullbright)
"i" = (
/turf/open/misc/beach/sand,
/area/deathmatch/fullbright)
"j" = (
/turf/open/misc/beach/coast,
/area/deathmatch/fullbright)
"l" = (
/obj/structure/chair/pew/right{
	dir = 1
	},
/obj/item/storage/toolbox/drone{
	pixel_x = 3;
	pixel_y = -8
	},
/turf/open/indestructible/hotelwood,
/area/deathmatch/fullbright)
"p" = (
/turf/open/indestructible{
	icon_state = "grass"
	},
/area/deathmatch/fullbright)
"q" = (
/turf/open/misc/beach/coast/corner{
	dir = 1
	},
/area/deathmatch/fullbright)
"r" = (
/turf/open/misc/beach/coast{
	dir = 1
	},
/area/deathmatch/fullbright)
"t" = (
/turf/open/misc/beach/coast{
	dir = 6
	},
/area/deathmatch/fullbright)
"v" = (
/obj/effect/landmark/deathmatch_player_spawn,
/turf/open/indestructible{
	icon_state = "sand"
	},
/area/deathmatch/fullbright)
"w" = (
/obj/structure/statue/gold/hos{
	name = "statue of the epstein"
	},
/turf/open/indestructible/hotelwood,
/area/deathmatch/fullbright)
"x" = (
/turf/open/indestructible/hotelwood,
/area/deathmatch/fullbright)
"A" = (
/obj/structure/flora/tree/palm,
/turf/open/indestructible{
	icon_state = "grass"
	},
/area/deathmatch/fullbright)
"C" = (
/turf/open/indestructible{
	icon_state = "sand"
	},
/area/deathmatch/fullbright)
"E" = (
/turf/open/misc/beach/coast{
	dir = 4
	},
/area/deathmatch/fullbright)
"G" = (
/obj/machinery/syndicatebomb{
	active = 1;
	timer_set = 420
	},
/obj/item/stack/cable_coil/cut,
/turf/open/indestructible/hotelwood,
/area/deathmatch/fullbright)
"H" = (
/turf/open/misc/beach/coast/corner{
	dir = 4
	},
/area/deathmatch/fullbright)
"I" = (
/turf/open/water/beach,
/area/deathmatch/fullbright)
"J" = (
/obj/item/clothing/gloves/color/yellow,
/turf/open/indestructible/hotelwood,
/area/deathmatch/fullbright)
"K" = (
/obj/effect/landmark/deathmatch_player_spawn,
/turf/open/water/beach,
/area/deathmatch/fullbright)
"M" = (
/obj/structure/flora/tree/palm/style_2,
/turf/open/indestructible{
	icon_state = "grass"
	},
/area/deathmatch/fullbright)
"N" = (
/obj/structure/mineral_door/wood{
	opacity = 0
	},
/turf/open/indestructible/hotelwood,
/area/deathmatch/fullbright)
"P" = (
/obj/structure/flora/coconuts,
/turf/open/misc/beach/sand,
/area/deathmatch/fullbright)
"Q" = (
/obj/structure/altar,
/obj/effect/mob_spawn/corpse/human,
/turf/open/indestructible/hotelwood,
/area/deathmatch/fullbright)
"R" = (
/obj/structure/flora/tree/palm,
/turf/open/misc/beach/sand,
/area/deathmatch/fullbright)
"S" = (
/turf/open/misc/beach/coast{
	dir = 5
	},
/area/deathmatch/fullbright)
"T" = (
/turf/closed/indestructible/reinforced{
	icon_state = "wall-0";
	icon = 'modular_meta/features/deathmatch/icons/island_operation.dmi';
	opacity = 0;
	base_icon_state = "wall"
	},
/area/deathmatch/fullbright)
"U" = (
/turf/open/misc/beach/coast{
	dir = 8
	},
/area/deathmatch/fullbright)
"V" = (
/obj/effect/landmark/deathmatch_player_spawn,
/turf/open/misc/beach/coast{
	dir = 4
	},
/area/deathmatch/fullbright)
"W" = (
/obj/structure/flora/tree/palm/style_2,
/turf/open/misc/beach/sand,
/area/deathmatch/fullbright)
"X" = (
/turf/open/misc/beach/coast/corner{
	dir = 8
	},
/area/deathmatch/fullbright)
"Z" = (
/turf/open/misc/beach/coast{
	dir = 9
	},
/area/deathmatch/fullbright)

(1,1,1) = {"
a
a
a
a
a
a
a
a
a
a
a
a
a
a
a
a
a
a
a
a
a
a
a
a
a
a
a
a
a
a
a
a
a
a
a
a
a
a
a
a
"}
(2,1,1) = {"
a
a
a
a
a
a
a
a
a
a
a
a
a
a
a
a
a
a
a
a
a
a
a
a
a
a
a
a
a
a
a
a
a
a
a
a
a
a
a
a
"}
(3,1,1) = {"
a
a
a
a
a
a
a
a
a
a
a
a
a
a
a
a
I
I
I
I
I
I
I
I
I
I
I
I
a
a
a
a
a
a
a
a
a
a
a
a
"}
(4,1,1) = {"
a
a
a
a
a
a
a
a
a
a
a
a
a
I
I
I
I
I
I
I
I
I
I
I
I
I
I
I
I
I
I
a
a
a
a
a
a
a
a
a
"}
(5,1,1) = {"
a
a
a
a
a
a
a
a
a
a
I
I
I
I
I
I
I
I
I
I
I
I
I
I
I
I
I
I
I
I
I
I
a
a
a
a
a
a
a
a
"}
(6,1,1) = {"
a
a
a
a
a
a
I
I
I
I
I
I
I
I
I
I
I
I
I
K
I
I
I
I
I
Z
U
U
U
d
I
I
I
a
a
a
a
a
a
a
"}
(7,1,1) = {"
a
a
a
a
a
I
I
I
I
I
I
I
I
I
I
I
I
I
I
I
I
I
Z
U
U
H
i
i
i
j
I
I
I
I
a
a
a
a
a
a
"}
(8,1,1) = {"
a
a
a
a
a
I
I
K
I
I
I
Z
U
U
U
U
U
U
U
U
U
U
H
i
i
i
i
i
i
q
d
I
I
I
a
a
a
a
a
a
"}
(9,1,1) = {"
a
a
a
a
I
I
I
Z
U
U
U
H
i
i
i
i
i
i
i
i
i
i
i
i
i
i
i
R
i
i
j
I
I
I
a
a
a
a
a
a
"}
(10,1,1) = {"
a
a
a
a
I
I
Z
H
i
i
i
i
i
i
i
i
i
i
i
i
i
i
i
i
R
i
i
P
i
i
j
I
I
I
a
a
a
a
a
a
"}
(11,1,1) = {"
a
a
a
I
I
I
r
i
i
i
i
i
i
p
p
p
p
p
p
p
p
p
p
i
i
i
W
i
i
i
j
I
I
I
a
a
a
a
a
a
"}
(12,1,1) = {"
a
a
a
I
I
Z
H
i
i
i
p
p
p
p
p
p
A
p
p
M
p
p
M
p
p
p
i
i
R
i
j
I
I
I
a
a
a
a
a
a
"}
(13,1,1) = {"
a
a
a
I
I
r
i
i
i
p
p
p
M
p
p
p
p
p
p
p
p
p
p
p
p
p
p
i
i
i
j
I
I
I
a
a
a
a
a
a
"}
(14,1,1) = {"
a
a
I
I
I
r
i
i
p
p
p
p
p
p
M
p
p
M
p
p
M
p
p
M
p
p
p
i
i
i
q
d
K
I
I
a
a
a
a
a
"}
(15,1,1) = {"
a
a
I
I
I
r
i
i
p
M
p
A
p
p
p
p
p
p
p
p
p
p
p
p
p
M
p
i
i
i
i
j
I
I
I
a
a
a
a
a
"}
(16,1,1) = {"
a
a
I
I
I
r
i
i
p
p
p
T
T
T
T
T
T
T
p
p
p
p
p
p
p
p
p
i
i
i
i
j
I
I
I
a
a
a
a
a
"}
(17,1,1) = {"
a
a
I
I
I
r
i
p
A
p
p
T
e
x
f
f
x
T
p
p
p
p
p
p
A
p
p
p
i
i
i
q
d
I
I
I
a
a
a
a
"}
(18,1,1) = {"
a
a
I
I
I
r
i
p
p
p
p
T
w
x
l
h
x
T
C
C
p
C
C
C
p
p
C
C
i
i
i
i
j
I
I
I
a
a
a
a
"}
(19,1,1) = {"
a
a
I
I
K
r
i
p
p
M
p
T
Q
x
G
J
x
N
C
v
C
C
C
C
C
C
C
C
i
i
i
i
j
I
I
I
a
a
a
a
"}
(20,1,1) = {"
a
a
I
I
I
r
i
M
p
p
p
T
x
x
f
f
x
T
C
p
C
C
p
C
C
C
p
p
i
i
i
i
j
I
I
I
I
a
a
a
"}
(21,1,1) = {"
a
a
I
I
I
r
i
p
p
p
p
T
e
x
h
h
x
T
p
p
p
p
p
p
p
p
p
p
i
i
i
i
j
I
I
I
I
a
a
a
"}
(22,1,1) = {"
a
a
I
I
I
r
i
i
p
M
p
T
T
T
T
T
T
T
p
p
p
p
p
p
p
p
p
p
i
i
i
i
j
I
I
I
I
a
a
a
"}
(23,1,1) = {"
a
a
I
I
I
r
i
i
p
p
p
p
p
p
p
p
p
p
p
p
p
p
p
p
M
p
p
i
i
i
i
i
j
I
I
I
I
a
a
a
"}
(24,1,1) = {"
a
a
I
I
I
r
i
i
p
p
p
A
p
p
p
p
p
A
p
p
p
p
p
p
p
p
p
i
W
i
i
i
j
I
I
I
I
a
a
a
"}
(25,1,1) = {"
a
a
I
I
I
r
i
i
p
M
p
p
p
p
A
p
p
p
p
p
M
p
p
p
p
p
i
i
i
P
i
i
j
I
I
I
I
a
a
a
"}
(26,1,1) = {"
a
a
I
I
I
r
i
i
p
p
p
p
p
p
p
p
p
p
p
p
p
p
p
p
p
A
i
i
i
i
i
i
j
K
I
I
I
a
a
a
"}
(27,1,1) = {"
a
a
a
I
I
r
i
i
i
p
p
p
M
p
p
p
p
p
A
p
p
p
A
p
p
p
i
R
P
i
i
g
t
I
I
I
I
a
a
a
"}
(28,1,1) = {"
a
a
a
I
I
S
X
i
i
i
i
i
p
p
p
p
A
p
p
p
p
p
p
p
p
p
i
i
i
R
i
j
I
I
I
I
I
a
a
a
"}
(29,1,1) = {"
a
a
a
a
I
I
S
X
i
i
i
i
i
i
p
p
p
p
p
p
A
p
p
A
p
i
i
i
i
i
i
j
I
I
I
I
a
a
a
a
"}
(30,1,1) = {"
a
a
a
a
I
I
I
S
E
E
X
i
i
i
i
i
i
i
i
p
p
p
p
i
i
i
W
i
i
i
i
j
I
I
I
I
a
a
a
a
"}
(31,1,1) = {"
a
a
a
a
a
I
I
I
I
I
S
E
E
V
X
i
i
i
i
i
i
i
i
i
i
i
i
i
i
i
g
t
I
I
I
a
a
a
a
a
"}
(32,1,1) = {"
a
a
a
a
a
I
I
I
I
I
I
I
I
I
S
E
E
E
X
i
i
i
i
g
E
X
i
i
i
g
t
I
I
I
I
a
a
a
a
a
"}
(33,1,1) = {"
a
a
a
a
a
I
I
K
I
I
I
I
I
I
I
I
I
I
S
E
E
E
E
t
I
S
E
E
E
t
I
I
I
I
a
a
a
a
a
a
"}
(34,1,1) = {"
a
a
a
a
a
a
I
I
I
I
I
I
I
I
I
I
I
I
I
I
I
K
I
I
I
I
I
I
K
I
I
I
I
I
a
a
a
a
a
a
"}
(35,1,1) = {"
a
a
a
a
a
a
a
I
I
I
I
I
I
I
I
I
I
I
I
I
I
I
I
I
I
I
I
I
I
I
I
I
I
a
a
a
a
a
a
a
"}
(36,1,1) = {"
a
a
a
a
a
a
a
a
a
I
I
I
I
I
I
I
I
I
I
I
I
I
I
I
I
I
I
I
I
I
I
a
a
a
a
a
a
a
a
a
"}
(37,1,1) = {"
a
a
a
a
a
a
a
a
a
a
a
a
a
I
I
I
I
I
I
I
I
I
I
I
I
I
I
I
I
a
a
a
a
a
a
a
a
a
a
a
"}
(38,1,1) = {"
a
a
a
a
a
a
a
a
a
a
a
a
a
a
a
a
a
I
I
I
I
I
I
I
I
a
a
a
a
a
a
a
a
a
a
a
a
a
a
a
"}
(39,1,1) = {"
a
a
a
a
a
a
a
a
a
a
a
a
a
a
a
a
a
a
a
a
a
a
a
a
a
a
a
a
a
a
a
a
a
a
a
a
a
a
a
a
"}
(40,1,1) = {"
a
a
a
a
a
a
a
a
a
a
a
a
a
a
a
a
a
a
a
a
a
a
a
a
a
a
a
a
a
a
a
a
a
a
a
a
a
a
a
a
"}
